*	INFRASPECIFIC_NAME
**	INFRASPECIFIC_NAME
***	INFRASPECIFIC_NAME
****	INFRASPECIFIC_NAME
*****	INFRASPECIFIC_NAME
?	UNRANKED
??	UNRANKED
???	UNRANKED
[alpha]	INFRASPECIFIC_NAME
[beta]	INFRASPECIFIC_NAME
[epsilon]	INFRASPECIFIC_NAME
[gamma]	INFRASPECIFIC_NAME
[infrafam unranked]	INFRAFAMILY
[infragen ]	INFRAGENUS
[infragen grex]	GREX
[infragen unranked]	INFRAGENUS
[infragen]	INFRAGENUS
[infrasp unranked]	INFRASPECIFIC_NAME
[unranked]	UNRANKED
\n	UNRANKED
a	UNRANKED
abber	ABERRATION
abberation	ABERRATION
aberrancy	ABERRATION
abt	PHYLUM
abteilung	PHYLUM
agamosp	SPECIES
agamovar	VARIETY
agg	SPECIES_AGGREGATE
agglom	SPECIES_AGGREGATE
aggr	SPECIES_AGGREGATE
aggregate	SPECIES_AGGREGATE
agregate	SPECIES_AGGREGATE
alliance
alpha	INFRASPECIFIC_NAME
ap	INFRASUBSPECIFIC_NAME
b	UNRANKED
beta	UNRANKED
biotype	BIOVAR
branch	UNRANKED
bv	BIOVAR
c	CLASS
chemotype	CHEMOFORM
cl	CLASS
clade	UNRANKED
clase	CLASE
class	CLASS
class	CLASS
classclade	CLASS
classe	CLASS
classis	CLASS
cohors	SUPRAGENERICNAME
cohort	SUPRAGENERICNAME
coll sp	INFRASPECIFIC_NAME
coll species	INFRASPECIFIC_NAME
complex	SPECIES_AGGREGATE
convar	CONVARIETY
ct	CHEMOFORM
cultivar	CULTIVAR
cultivar	CULTIVAR
cultivar_group	CULTIVAR_GROUP
cultivargroup	CULTIVAR_GROUP
cv	CULTIVAR
d	UNRANKED
div	PHYLUM
divisao	PHYLUM
divisio	PHYLUM
division	PHYLUM
domain	DOMAIN
empire	DOMAIN
es	SPECIES
espece	SPECIES
especie	SPECIES
especies	SPECIES
f	FORM
f sp	FORM
fam	FAMILY
familia	FAMILY
family	FAMILY
family	FAMILY
familyclade	FAMILY
fm	FAMILY
fma	FORM
for	FORM
form	FORM
form	FORM
forma	FORM
g	GENUS
gat	GENUS
gattung	GENUS
gen	GENUS
genero	GENUS
gennus	GENUS
genus	GENUS
genus	GENUS
gn	GENUS
genusclade	GENUS
gnero	GENUS
groupgenus	GENUS
groupspecies	SPECIES
imperium	KINGDOM
kingdomclade	KINGDOM
grex	GREX
grex sect	GREX
group	CULTIVAR_GROUP
higher taxon	SUPRAGENERICNAME
hybrid formula	HYBRID FORMULA
infraclass	INFRACLASS
infraclassis	INFRACLASS
infragen	INFRAGENUS
infragen.unranked	INFRAGENERICNAME
infrageneric	INFRAGENERICNAME
infrageneric_name	INFRAGENERIC_NAME
infragenericname	INFRAGENERICNAME
infragenerictaxon	INFRAGENERICTAXON
infragenus	INFRAGENUS
infrakingdom	INFRAKINGDOM
infraregnum	INFRAKINGDOM
infraorder	INFRAORDER
infraordo	INFRAORDER
infraorder	INFRAORDER
infraphylum	INFRAPHYLUM
infrasp	INFRASPECIFIC_NAME
infrasp.unranked	INFRASPECIFIC_NAME
infraspecies	INFRASPECIFIC_NAME
infraspecific	INFRASPECIFIC_NAME
infraspecific_name	INFRASPECIFIC_NAME
infraspecificname	INFRASPECIFIC_NAME
infraspecifictaxon	INFRASPECIFIC_NAME
infrasubspecific name	INFRASUBSPECIFIC_NAME
infrasubspecific_name	INFRASUBSPECIFIC_NAME
infrasubspecificname	INFRASUBSPECIFIC_NAME
intergen hybrid	UNRANKED
k	KINGDOM
kd	KINGDOM
king	KINGDOM
kingdom	KINGDOM
kingdom	KINGDOM
kl	CLASS
kla	CLASS
klasse	CLASS
legio	SUPRAGENERICNAME
lysotype	PHAGOVAR
microgen	INFRAGENERICNAME
monstr	MONSTR
morphotype	MORPHOVAR
nat	NATIO
natio	NATIO
nm	
no rank	UNRANKED
norank	UNRANKED
node	UNRANKED
none	UNRANKED
nothof	FORM
nothoform	FORM
nothogenus	GENUS
nothosect	SECTION
nothoser	SERIES
nothospecies	SPECIES
nothosubgen	SUBGENUS
nothosubsect	SUBSECTION
nothosubsp	SUBSPECIES
nothosubspecies	SUBSPECIES
nothosubtrib	SUBTRIBE
nothotaxon	UNRANKED
nothovar	VARIETY
nothovariety	VARIETY
o	ORDER
or	ORDER
ord	ORDER
ordem	ORDER
order	ORDER
orden	ORDER
ordo	ORDER
orderclade	ORDER
p	PHYLUM
pars	
parvorder	INFRAORDER
pathotype	PATHOVAR
ph	PHYLUM
phagotype	PHAGOVAR
phyl	PHYLUM
phylum	PHYLUM
phylumclade	PHYLUM
phylumdivision	PHYLUM
physiological type	BIOVAR
prol	PROLES
prolata	PROLES
proles	PROLES
pseudovar	
race	RACE
reg	KINGDOM
regn	KINGDOM
regnum	KINGDOM
reich	KINGDOM
ribe	TRIBE
root	UNRANKED
s	SPECIES
sec	SECTION
sec ion	SECTION
sect	SECTION
sectio	SECTION
section	SECTION
section	SECTION
ser	SERIES
serie	SERIES
series	SERIES
series	SERIES
serotype	SEROVAR
sge	SUBGENUS
sous-classe	SUBCLASS
sp	SPECIES
spe	SPECIES
spec	SPECIES
special form	FORMA_SPECIALIS
special form	FORMA_SPECIALIS
species	SPECIES
species	SPECIES
species group	SPECIES_AGGREGATE
speciesgroup	SPECIES_AGGREGATE
species subgroup	SPECIES_AGGREGATE
speciesaggregate	SPECIES_AGGREGATE
ss	SUBSPECIES
ssp	SUBSPECIES
sses	SUBSPECIES
stamm	PHYLUM
stirps	UNRANKED
strain	STRAIN
strain	STRAIN
sub ribe	SUBTRIBE
sub variety	SUBVARIETY
sub_especie	SUBSPECIES
subespecie	SUBSPECIES
subgenero	SUBGENUS
subbranch	UNRANKED
subcl	SUBCLASS
subclass	SUBCLASS
subclass	SUBCLASS
subclassis	SUBCLASS
subclase	SUBCLASS
subdiv	SUBPHYLUM
subdivisio	SUBPHYLUM
subdivision	SUBPHYLUM
subf	SUBFAMILY
subfam	SUBFAMILY
subfamilia	SUBFAMILY
subfamily	SUBFAMILY
subfamily	SUBFAMILY
subform	SUBFORM
subform	SUBFORM
subforma	SUBFORM
subg	SUBGENUS
subgen	SUBGENUS
subgenus	SUBGENUS
subgenus	SUBGENUS
subhybr	INFRASUBSPECIFIC_NAME
subkingdom	SUBKINGDOM
subkingdom	SUBKINGDOM
sublus	INFRASUBSPECIFIC_NAME
subord	SUBORDER
suborder	SUBORDER
suborder	SUBORDER
subordo	SUBORDER
subphyl	SUBPHYLUM
subphylum	SUBPHYLUM
subphylum	SUBPHYLUM
subregn	SUBKINGDOM
subregnum	SUBKINGDOM
subsec ion	SUBSECTION
subsect	SUBSECTION
subsectio	SUBSECTION
subsection	SUBSECTION
subsection	SUBSECTION
subser	SUBSERIES
subseries	SUBSERIES
subseries	SUBSERIES
subsp	SUBSPECIES
subspec	SUBSPECIES
subspecies	SUBSPECIES
subspecies	SUBSPECIES
subspeciesaggregate	INFRASPECIFIC_NAME
subsubf	INFRASUBSPECIFIC_NAME
subsubvar	INFRASUBSPECIFIC_NAME
subtrib	SUBTRIBE
subtribe	SUBTRIBE
subtribe	SUBTRIBE
subtribus	SUBTRIBE
subvar	SUBVARIETY
subvarietas	SUBVARIETY
subvariety	SUBVARIETY
subvariety	SUBVARIETY
superclass	SUPERCLASS
superclass	SUPERCLASS
superclassis	SUPERCLASS
superdivision	SUPERPHYLUM
superfamily	SUPERFAMILY
superfamily	SUPERFAMILY
superkingdom	DOMAIN
superorder	SUPERORDER
superorder	SUPERORDER
superordo	SUPERORDER
superphyl	SUPERPHYLUM
superphylum	SUPERPHYLUM
superphylum	SUPERPHYLUM
superphylum	SUPERPHYLUM
superregnum	DOMAIN
supersect	SUPRAGENERICNAME
superser	SUPRAGENERICNAME
superseries	SUPERSERIES
supersubtrib	SUPRAGENERICNAME
supersubtribe	SUPERSUBTRIBE
supertrib	SUPRAGENERICNAME
supertribe	SUPRAGENERICNAME
suprageneric_name	SUPRAGENERIC_NAME
supragenericname	SUPRAGENERICNAME
suprasect	SUPRAGENERICNAME
t infgen	INFRAGENERICNAME
t infr	INFRASPECIFIC_NAME
tax infragen	INFRAGENERICNAME
tax vag	UNRANKED
trib	TRIBE
tribe	TRIBE
tribe	TRIBE
tribo	TRIBE
tribus	TRIBE
uab	SUBPHYLUM
ukl	SUBCLASS
unknown	UNRANKED
unranked	UNRANKED
unranked	UNRANKED
unranked clade	UNRANKED
unterabteilung	SUBPHYLUM
v	VARIETY
var	VARIETY
varie as	VARIETY
varie y	VARIETY
variedad	VARIETY
variedade	VARIETY
varietas	VARIETY
variety	VARIETY
variete	VARIETY
zoodivisio	SUBCLASS
zoosectio	INFRAORDER
µ	UNRANKED
ß	UNRANKED
ßß	UNRANKED
α	UNRANKED
γ	UNRANKED
δ	UNRANKED
